1111111111
1000000001
1111111101
1000000001
1001011101
1011011101
1001001001
1000111001
1000000001
1111110001
1000000001
1110001111
1000000001
1000040001
1111111111